10 10
1111111111
1111111111
1111111111
1111111111
1111111111
0000101000
0000101000
0000101000
0000020000
0000000000
