X 10 10
0200000000
2200000000
0000000000
0000000000
0000000000
0000101000
0000101000
0000101000
0000020000
0000000000
